1,0,5,0,0
0,0,0,4,2
5,5,0,0,0
0,0,4,0,0
0,0,0,0,0