0,0,0,0,0
0,1,5,0,0
5,2,4,0,5
0,0,0,0,0
0,0,0,0,0