0,0,0,0,0
0,0,4,2,0
3,0,0,0,0
0,1,0,3,0
0,0,0,0,0