0,0,0,0,3
0,4,4,0,0
0,1,5,3,0
0,0,0,0,2
0,0,0,0,0