0,0,5,0,0
0,5,1,2,0
0,0,5,0,0
0,0,0,0,4
0,0,0,0,0