0,0,0,0,0
0,0,2,4,0
0,0,0,0,0
0,4,1,0,3
0,0,0,0,0